**********************************************
* *   **         *   * **    * *    ***** ****
*   *    ***** *** *      **     ** ***      *
*** *** ** *** * * **** ***** * ***** * *** **
**   *  **   *       *  *** *   *       ***  *
** * **    * ****** ** **     *** ** **  ** **
** *  **** *     **  *  * * ****   *******  **
*  **      ***** *** **   *    *** **   ** ***
* **  ** *         * ****** **        * **   *
* ** **  ********* *        **** *** **    ***
*  *    ****     * **** * **** *  ****** *****
** ******    *** *      *      *******    ****
**    *   ****   ***** *** ***    ***** *** **
*****   * * *  *     *x     ** **    *      **
*** *****   * *** ** ** * **** **** ***** *  *
**   *    ***  ** ***** *   *****    **   * **
*  *   ****** **   **   ***   * * ****** ** **
** *******     ** **** **** ***      *** *   *
**         *** *  **   **   *** ******   *****
**** *** ***     *** *  * ***       ** ***  **
***  *   **** *****  ****   ** ** *  *     ***
*** *** ** *     ** ****  * **    ** **** ** *
**    *      ***       ****  ** ***    *     *
**********************************************