******* 
*     **
** x   *
 *    **
 * **** 
 *    **
***    *
*      *
*   *  *
* * ****
* *    *
* *    *
********