*************
*           *
*           *
*           *
*     x     #
*           #
*           #
*           *
*************