******* 
*     **
**    x*
 *    **
 * **** 
 *    **
***    *
*      *
*   *  *
* *** **
* *    *
* *    *
********
