********************************
*    **     *    *      *    ***
* **    *** ** * ** *** * ** ***
*  ** *** ***       * * * **   *
** ** **  ****** **   *    * * *
** *   **    *    *** **** *   *
*  * * *  * ** **   *  *   ** **
* **** ** *   X *** ** * *    **
* * *       ** ***  *  * ** ****
* * *** ** **    * *** ***     *
*   *    ***  ** * *     *** ***
* *   **   * **    ** **      **
* *** *  *** ** **  * *** ***  *
***   ** *      ***   *   **   *
********************************
